GivenName	Surname
Dagrún	Valtýsdóttir
Hui	Tang
Rosette	Sæland
Hendrik	Ket
Andrew	Andreev
Aune	Hietamäki
Ora	Siegel
Tam	Đặng
Inunnguaq	Josefsen
Khamzat	Rushisvili
Tome	Gotvajn
Juho	Ylihärsilä
Fortuna	Uribe
Jumah	Ba
Khamza	Usamov
Balbo	Grubb
Gigliola	Toscani
Athanaric	Roper
Darinka Martina	Duvnjak
Rhoda	Lightfoot
Sven	Gloeckner
Corinna	Fiorentini
Akwaugo	Yobanna
Orane	Raymond
Polo	Smallburrow
Diane	Lanoie
William	Doran
Bente	Carlsen
Yi	Shen
Bo	Sung
Denise	Sanabria
Catherine	Glidden
Carys	Cunningham
Leonid	Vikse
Patrekur	Ásbjörnsson
Jacob	Lind
Libera Maria	Dellucci
Ukamaka	Chinagorom
Brogan	White
Gordey	Belov
Alyssa	Penfold
Sonia	Pukmajster
Ríkey	Friðleifsdóttir
Aðalheiður	Gylfadóttir
Aiden	Cameron
Husn	Botros
Faruz	Medhane
Marroc	Goodbody
Katie	Jacob
Katja	Klug
Mike	Vogel
Walt	Wensing
Mathilde	Labossière
Abdul-Nasser	Atiyeh
Gabriel	Governor
Chiemezie	Chialuka
Dobrovit	Kovačević
Luwam	Aman
Basilah	Daher
Jak	Mitchell
Karl	Lynge
Anne	Schiffer
Dehab	Osman
Bogdan	Antunović
Wei	Jen
Silvano	Amador
Svjetlana	Bilić
Azni	Kadiev
Carla	Dias
Ingegerd	Økland
Anna	Broberg
Ký	Hàn
Ty	Mai
Peter	Holtzmann
Emmanuel	Sidorov
Adony	Ságy
Martina	Schulz
Amelia	Casimaty
Zoárd	Szántó
Maik	Loewe
Rose	Labingi
Pipaluk	Rosing
Nieve	McDonald
Tošo	Jusufović
Adélaïde	Cailot
Cecilia	Muñiz
Angelika	Drescher
Samija	Schmitzberger
Maren	Geisler
Rebeca	Pereira
Diane	Hall
John	Gibson
Fortinbras	Burrowes
Bergdís	Finnbogadóttir
Sanelma	Kangas
Kasper	Mathiasen
Yesenia	Ignatyeva
Iloerika	Nnamdi
Kaypa	Kishiev
Albert	Arnaldsson
Isla	Fitzpatrick
Tám	Lương
Jan	Lang
Kondrat	Kalinowski
Tiblets	Berhane
Obielumani	Tobeolisa
Wegahta	Adonay
Moana	Willekens
Ingólfur	Þorsteinsson
Idara	Nieves
Villette	Beaudry
Rushdi	Bishara
Thyrza	Wagenvoort
Kevin	Wulf
Mike	Isaksson
Hoshiyo	Yamada
Machi	Fujisawa
Anka	Kwiatkowska
Isaäc	Denekamp
Eliane	Avilés
Nabeeha	Koury
Fealty	Lépicier
Nansen	Eriksen
Mithad	Klinčar
Hui	Ku
Xin	Lương
Nikodem	Symanski
Prima	Goodbody
Nediljko	Kolar
Morgan	Jennings
Anna	Ferreira
Bi	Triệu
Ralf	Unger
Zekö	Puskás
Feng	Yüan
Andrija	Rukavina
Shouji	Nishimura
Olga	Tadić
Michael	Florence
Miriam	Levitt
Ako	Miura
Najla	Atiyeh
Jyri	Hirvi
Wacława	Król
Vappu	Lämpsä
Björgvin	Maríasson
Bogdana	Vidaković
Matilda	Gordon
Hannah	Holst
Eugene	Mishina
Bergvin	Másson
Søren	Andersen
Włodzimierz	Chmielewski
Marie	Šimíková
Owen	Faulkner
Mai	Saibara
Juvencio	Corrales
Quỳnh	Vũ
Tammam	Rahal
Marika	Kultsár
Chariton	Voronov
Julia	Farrell
Manouk	Mors
Benjamin	Gregersen
Sven	Werner
Ruby	Naylor
Ali	Kooper
Jasminka	Novak
Mazhar	Bata
Maja	Christoffersen
Desirée	Hansson
Emina	Shiyouji
Pedro	Pereira
Ninacska	Erdélyi
Uffo	Hayward
Veronika	Antunović
Julie	Brandt
Nicholas	Heath
Jakob	Jørgensen
Tia	Gill
Napoleone	Panicucci
Asmarina	Adonay
Michael	Fikru
Lin Yao	Kang
Matthew	Bogdanov
Tânia	Carvalho
Pascaline	Chesnay
Ninh	Bùi
Stefán	Guðsteinsson
Leona	Markulić
Fariq	Amari
Martin	Freytag
Corine	Mohammed
Gróa	Guðnadóttir
Jiska	de Lijster
Melania	Shcherbakova
Fábio	Castro
Kifle	Girma
Tobenna	Obioma
Thuận	Nguyễn
Nadzieja	Wysocka
Ekwueme	Otutodilinna
Felicia	Ågotnes
Andrew	Vasin
Qian	Wang
Ephraim	Bulgakov
Valeria	Ermakova
Song	Han
Ugo	Piazza
Fastolph	Puddifoot
Feng	T'ien
Adéla	Kuběnová
Johanne	Kleist
Pernille	Iversen
Hermann	Gunnarsson
Christine	Freud
Ladislav	Čech
Scott	Davis
Ophelia	Narváez
Dobromila	Tranová
Duy	Nguyễn
Arnþrúður	Eggertsdóttir
Mika-Matti	Hartonen
Feaven	Nebay
Wang	Hu
Abel	Goytiom
Fayette	Saindon
Souad	Quraishi
Ennio	Lucchese
Daniel	Cavalcanti
Manu	Hahl
John	Smith
Ý	Trịnh
Chidiegwu	Oluchukwu
Milen	Isaias
Sáu	Tạ
Olkhazar	Vedzizhev
Tới	Nghiêm
Chovka	Godina
Andrea	Muench
Ninfa	DeRose
Malik	Månsson
Berk	Bosse
Tihomil	Lončar
Teo	Vučan
Reijo	Kaitainen
Dionisia	Toscani
Petra	Šmehlíková
Lệ	Nguyễn
Asger	Jakobsen
Israpil	Panova
Diana	Poljak
Arán	Cortés
Sonnie	Mork
Asphodel	Sandyman
Denize	Eriksson
Miroš	Mihaljević
Ida	Kokkonen
Alfred	Mikkelsen
Ludvig	Johansen
Merle	Paiement
Hảo	Trương
Margaret	Alexandrova
Arduino	Romani
Ondřej	Havlíček
Hanne	Kreutzmann
Ole	Hansen
Taemi	Kikuchi
Aki	Morikawa
Berardo	Calabresi
Heliena	Jaimes
Brogan	Crawford
Hugo	Poutanen
Claartje	Zegwaard
Tosh	Nielsen
Mirjam	Martinsson
Leanna	Thomson
Renej	Španger
Senta	Ogawa
Natalia	Prokhorova
Konstantyn	Kozłowski
Jerry	Lindström
Abubakar	Umkhayev
Liên	Chung
Alvin	Esposito
Orce	Vidigoj
Vanda	Seres
Helena	Paija
Rui	Kouki
Odinakachukwu	Enyinnaya
Dũng	Mai
Rayyan	Mifsud
Josef	﻿Němec
Zarifa	Gošnik
Friðþjófur	Tryggvason
Phượng	Hoàng
Sebastian	Bogdanov
Na'imah	Said
Jan	Herrmann
Karoline	Pedersen
